conceited(e ke baad i not like field) : immodest or not modest/overconfident/lacking decency/boastful(he's a conceited man)
modest : diffident/fair/humble/less confident/decent(ram is a modest boy)
disdain : antipathy/insolence/contempt/disrespect(her upper lip curled in disdain at the work of the employee)
impetuous : (impulsive) acting or done quickly without thought of consequence(in an impulsive/impetuous decision, he quit his job)
fawning : trying to win favour/chaploosi/flattery(she was always fawning "ON" boss to get promotion)
hyperbole : part of speech that needs to be exaggerated/emphasized(special fact)
bumble : act/talk clumsy/awkwardly
1 blonde,2 brunette : 1 white/golden/grey hair women, 2 brown hair women(light brown/dark brown)
interpose : insert/intervene/interruption(The teacher interposed herself between the two fighting students to stop them)(He paused and interposed a question, "May I help you?". )
stout : corpulent/fat
aberrant : deviated from moral path(spherical aberration/focus se bhatakna)
flunk : fail to meet required standard(i flunked biology in 10th class)
ajar : slightly open(he left the window ajar)
alleviate : opposite of aggravate
treason : betrayel/disloyalty/treachery(des droh)
peculiar : strange/odd(he gave her some very peculiar looks)
quiver : temble/shaking(tree branches stopped quivering as the winds slowed down)
in-apprehensible : no comprehensible/not understandable
impregnable : can't be done by force(the fortress wall was impregnable, resisting all the attempts of invasion)
besides vs beside(without s) : besides means in additio/iske alava(Besides English, she speaks French and Spanish) & beside means adjacent(He sat beside me on the bus)
ExhilArAted : all this hustle & bustle makes me feel exhilarated(very happy)
condone : i never condone violence for any reason(accepting the wrong)
delinquent : your delinquent son(tending to commit crime specially young ones)
disenchanted : she became disenchanted with her job after realizing there was no room for growth(stopped admiring/disillusioned/got the truth)
dissonance : dissonance among the candidates should be seen as a bad sign(disharmony, also for music context)
futile : all his efforts to convince were futile(useless)
tenacity : her tenacity helped her overcome all the challenges(quality of being persistent=consistent even after failures) | she was persistent in asking for help until she got it
intrinsic | extrinsic : kindness is an intrinsic quality of a good leader(inherent,natural,essential,belonging, bole to vo jo andar se aata hai) | his motivation was extrinsic, driven by reward & praise(opposite of intrinsic)
extraneous : remove all the extraneous info from your essay(extra, redundant)
impertinent(e) : the student's impertinent remark offended the teacher(rude/disrespecting)
obscured : the view of the harbor was partially obscured by the tree(blocked/hidden/unknown/concealed=>a line of sand dunes concealed the distant sea)
dis-saude/dishort/discourage(opposite of per-suade/encourage) : i tried to dissaudde/dehort her from leaving.
vacillated : he vacillated btw the 2 options(hesitation/ambivalency)
scour-ged : the dictator scourged his enemies without mercy(punish)
mag-nanimous(mega=bada dil se yaad rakh) : John was magnanimous & congratulated his opponent on his well deserved victory(generous & forgiving)
altruistic : his altruistic nature inspired her volunteer at the orphanage
faint-hearted : the climb to the mountain is not for the fainthearted(fattu/lacking courage)